00 00 00 00 00 00 00 00
00 00 00 00 00 00 00 00
00 00 00 00 00 00 00 00
00 00 00 00 00 00 00 00
00 00 00 00 00 00 00 00
00 00 00 00 00 00 00 00
00 00 00 00 00 00 00 00

f0 20 40 00 00 00 00 00
40 20 40 00 00 00 00 00
21 20 40 00 00 00 00 00
48 00 00 00 00 00 00 00
c4 21 40 00 00 00 00 00
d0 20 40 00 00 00 00 00
8f 21 40 00 00 00 00 00
74 20 40 00 00 00 00 00
40 20 40 00 00 00 00 00
62 1f 40 00 00 00 00 00
31 39 32 35 35 36 62 62
00
